11111111111111111111111111111111111111111111111111111111111111111111111111111111111111111111111111111111111111111111111111111111111111111111111111111111111111111
11111111111111111111111111111111111111111111111111111111111111111111111111111111111111111111111111111111111888888888888111111111111111111111111111111111111111111
11111111111111111111111111111111111111111111111111111111111111111111111111111111111111111111111111111111111811888888888111111111111111111111111111111111111111111
11111111111111111111111111111111111111111111111111111111111111111111111111111111111110000009999991111111111811888888888881111111111111111111111111111111111111111
111111111111111111111111111111111111111111111111111111111111111111111111111111111111100000m0999991111111111888888811118881111111111111111111111111111111111111111
11111111111111111111111111111111111111111111111111111111111111111111111111111111111990000000009999911111188881188811118888111111111111111111111111111111111111111
111111111111111111111111111111111111111111111111111111111111111111111111111111111119999xxxxxxx1999911111111881111118881111111111111000000001110111100101111111111
11111111111111111111111111111111111111111111111111111111111111111111111111111111111999999900001xxxxxx111111118811118881111111111111011111100000101010101110101111
11111111111111111111111111111111111111111111111111111111111111111111111111111111111999999900000000000111188118888888888888888000000111111100000010100100001111011
11111111111111111111111111111111111111111111111111111111111111111111111111111111111999999900000000000008888888888888888888888888880001111100000010000101101111011
11111111111111111111111111111111111111111111111111111111111111111111111111111111111999999900v00000000008888888888888888888888888880000111110101001110111101000001
11111111111111111111111111111111111111111111111111111111111111111111111111111111111119999000000000000008888888888888888888888888880000001111111100000010101000001
111111111111111111111111111111111111111111111111111111111111111111111111111111111111199990000009999000088888888888888888888888888800000000010101111111RRRR1000001
1111111111111111111111111111111111111111111111111111111111111111111111111111111111111xxxxxxxxxx999990000088888888888888888888888880000000000000000000000001000001
11111111111111111111111111111111111111111111111111111111111111111111111111111111111110000000999999990000011118888888888118888811180011101000000000000000001000111
11111111111111111100088888811111111111111111111111111111111111111111111111111111111110000000999999911111111111188881111118118811111111111110101010101010101101111
11111111111111111188888888811111111111111111111111111111111111111111111111111111111110000000099999911111111881111111111811111111111111111111111111111111111111111
11111111111111111188888888811111111111111111111111111111111111111111111111111111111111100000011111111111111888811118888811881111111111111111111111111111111111111
11111011211111111188888888811111111111111111111111111111111111111111111111111111111111100000011111111111111811888888888888888111111111111111111111111111111111111
11111000000111111188888888811111111111111111111111111111111111111111111111111111111111111000011111111111111811888888888888881111111111111111111111111111111111111
11111000000111111188888888811111111111111111111111111111111111111111111111111111111111111000011111111111111888888888888888881111111111111111111111111111111111111
11111000000111117188888888811111111111111111111111111111111111111111111111111111111111111000011111111111111888888888888888881111111111111111111111111111111111111
111110000v1110000001000000011111111111111111111111111111111111111111111111111111111111111000011111111111111888888888888888881111111111111111111111111111111111111
111000000000000000v0000001111111111111111111111111111111111111111111111111111111111111111000011111111111111111111111111111111111111111111111111111111111111111111
11100000000000000000000001111111111111111111111111111111111111111111111111111111111111111000011111111111111111111111111111111111111111111111111111111111111111111
111000000000000000000000016111111111111999000000v0000001100111111119999888811111111110000000000001111111111111111111111111111111111111111111111111111111111111111
11100000000000000000000000000111111111199900000000000000000111111119999888811111111110000000000001111111111111111111111111111111111111111111111111111111111111111
11188888110000000000111100000111199999999900000000W00000000000000F09999888888111111000000000001111011111111111111111111111111111111111111111111111111111111111111
11188888110000000000111100000111199999999000000000000000000000000F00999888888111111001111000001111011111111111111111111111111111111111111111111111111111111111111
111888881100000000v0151100000000009999999000011xx00xxxxxx00001100F00099888888111111001111000001611011111111111111111111111111111111111111111111111111111111111111
111888881111110000000000000000000009999w0000011000099999011111100F000000000001111110013110000000000111111111111111111111111111111111111111111d111111D111111111111
11188888111111000000000000000000000000000001111009999999011111111100000000000001111000000000000000000111111111111111111111111111111111110110000111100001101111111
11188888111311000000000000000000000000000001111099999990011111111000000v00000001111000000000v00000000111111111111111111111111111111111100000000111100000000111111
1118888800000000000111111111111111111110000111199999900001111111111000000000000000b000000000000000000111111111111111111111111111111111000000000111100000000011111
1118888800000000000111111111111111111110011111199990000001111111111000000000000000b000000000000000000111111111111111111111111111111111010000000111100000001011111
11188888000000000001111111111111111119900111111999000000011119911110000000000001111000000000000000011111111111111111111111111111111111000000000111100000000011111
111888888888800000011111111111111111199xx001111990001100000999911110000000000001111000000000000000011111111111111111111111111111111111000000000111100000000011111
1118888888888110000013110011111111111999000111111000111100099999T000000000011111111000111100000111111111111111111111111111111111111111111111111111111111111111111
11188888888881100000000000111111111119999111111110099911t00099900000000000011111111000111100000111111111111111111111111111111111111111111111111111111111111111111
11188888888881100000000000111111111119999111111110999999900000000000000111111111111110151100000131111111111111111111111111111111111111111111111111111111111111111
11188888888881100000000000011111111111111111111110999999990000000000000111111111111110000000000000011111111111111111111111111111111111111111111111111111111111111
1110000000000111111111111111111111111111111111111111111999900001111111111111111111111000000000000111111111111111111111111111111111111111001u11111111U100111111111
11100000000001111111111111111111111111111111111111111119999000011111111111111111111110000000000001111111111111111111111111111111111000000000001111000000000001111
111111111111111111111111111111111111111111110010Y0100111111111111111111111111111111111111000011111111111111111111111111111111111111001110000001111000000111001111
11111111111111111111111111111111111111111110001000100011111111111111111111111111111111111000011111111111111111111111111111111111111000000000001111000000000001111
11111111111111111111111111111111111111111110000000000011111111111111111111111111111999000000009991111111111111111111111111111111111001111000001111000001111001111
11111111111111111111111111111111111111111110000000000011111111111111111111111111111999900000099991111111111111111111111111111111111001111000001111000001111001111
11111111111111111111111111111111111111111111y01111111111111111111111111111111111199999900000099999911111111111111111111111111111111000000000001111000000000001111
1111111111111111111111111111111111111111111100111111111111111111111111111111111119999900000009999991111111111111111111111111111111111111111oo111111OO111111111111
1111111111111111111111111111111111111111111100000000111111111111111111111111111111199001xxxx119999000111111111111111111111111111111111111111111111111111111111111
1111111111111111111111111111111111111111111100Z101101111111111111111111111111111111xxxx10000111100000111111111111111111111111111111111111111111111111111111111111
11111111111111111111111111111111111111111111000101101111111111111111111111111111111000000000111100000111111111111111111111111111111111111111111111111111111111111
11111111111111111111111111111111111111111111011100001111111111111111111111111111111110v00000119900000111111111111111111111111111111111111111111111111111111111111
11111111111111111111111111111111111111111111000001111111111111111111111111111111111110000000999990000111111111111111111111111111111111111111111111111111111111111
111111111111111111111111111111111111111111110110z0111111111111111111111111111111111110000000999999000111111111111111111111111111111111111111111111111111111111111
11111111111111111111111111111111111111111111011000001111111111111111111111111111111110000000999999000111111111111111111111111111111111111111111111111111111111111
11111111111111111111111111111111111111111111011101101111111111111111111111111111111990000xxxx99999000111111111111111111111111111111111111111111111111111111111111
11111111111111111111111111111111111111111110000000000011111111111111111111111111199999000000011990011111111111111111111111111111111111111111111111111111111111111
11111111111111111111111111111111111111111110000000000011111111111111111111111111199999900000011990011111111111111111111111111111111111111111111111111111111111111
11111111111111111111111111111111111111111110010000010011111111111111111111111111111999900000011111111111111111111111111111111111111111111111111111111111111111111
11111111111111111111111111111111111111111110000000000011111111111111111111111111111999000000011111111111111111111111111111111111111111111111111111111111111111111
111111111111111111111111111111111111111111111111AA111111111111111111111111111111111111111110011111111111111111111111111111111111111111111111111111111111111111111
11111111111111111111111111111111111111111111111111111111111111111111111111111111111111111110011111111111111111111111111111111111111111111111111111111111111111111
11111111111111111111111111111111111111111111111111111111111111111111111111111111111111111110011111111111111111111111111111111111111111111111111111111111111111111
1111111111111111111111111111111111111111111111111111111111111111111111111111111111111111111bb11111111111111111111111111111111111111111111111111111111111111111111
11111111111111111111111111111111111111111111111111111111111111111111111111111111111000000000000000011111111111111111111111111111111111111111111111111111111111111
11111111111111111111111111111111111111111111111111111111111111111111111111111111111000000000000000011111111111111111111111111111111111111111111111111111111111111
11111111111111111111100100001000111111111111111111111111111111111111111111111111100000000000000000000111111111111111111111111111111111111111111111111111111111111
11111111111111111111110000000000011111111111111111111111111111111111111111111111100111110000001111100111111111111111111111111111111111111111111111111111111111111
111111111111111111111n0000000000011111111110010001111111111111111111111111111111100111110000001111100111111111111111111111111111111111111111111111111111111111111
111111111111111111111100000000000111111111100f0000000111111111111111111111111111100111110000001111100111111111111111111111111111111111111111111111011110111111111
1111111111111111111110000110011001111111111111000110011111111111111111111111111110011121v0000v1311100111111111111111111111111111111111111111110001000000011111111
1111111111111111111110010111111111111111111000000110011111111111111111111111111110000000000000000000011111111111111111111111111111111111111110000000i011001111111
11111111111111111111111111111111111111111110000001100111111111111111111111111111100000000000000000000111111111111111111111111111111111111111111110000000001111111
11111111111111111111111111111111111111111111000000000111111111111111111111111111100000000000000000000111111111111111111111111111111111111111111110000001101111111
111111111111111111111110111k110001111111111111SS11111111111111111111111111111111100000000000000000000111111111111111111111111111111111111111111110000001111111111
111111111111111111111000000000000111111111111111111111111111111111111111111111111000111111100r00v0000111111111111111111111111111111111111111100000000000001111111
11111111111111111111100000000000011111111111111111111111111111111111111111111111100011111110000000000111111111111111111111111111111111111111101000000000111111111
111111111111111111111N0000000011111111111111111111111111111111111111111111111111100011111110000000000111111111111111111111111111111111111111111100000001111111111
11111111111111111111100000000011111111111111111111111111111111111111111111111111100011114110000000011111111111111111111111111111111111111111111000000000111111111
111111111111111111111000000000011111111111111111111111111111111111111111111111111000000v0000000000011111111111111111111111111111111111111111100010000000001111111
11111111111111111111111111pp11111111111111111111111111111111111111111111111111111110000000000000011111111111111111111111111111111111111111111111111LL111111111111
11111111111111111111111111111111111111111111111111111111111111111111111111111111111000000000000001111111111111111111111111111111111111111111111111111111111111111
11111111111111111111111111111111111111111111111111111111111111111111111111111111111111111111111111111111111111111111111111111111111111111111111111111111111111111
11111111111111111111111111111111111111111111111111111111111111111111111111111111111111111111111111111111111111111111111111111111111111111111111111111111111111111
11111111111111111111111111111111111111111111111111111111111111111111111111111111111111111111111111111111111111111111111111111111111111111111111111111111111111111
11111111111111111111111111111111111111111111111111111111111111111111111111111111111111111111111111111111111111111111111111111111111111111111111111111111111111111
11111111111111111111111111111111111111111111111111111111111111111111111111111111111111111111111111111111111111111111111111111111111111111111111111111111111111111
